// Score (starts at zero for levels), Start Time (in milliseconds)
0 100000

13 10
YYYY YYYY YYYY YYYY YYYY YYYY YYYY YYYY YYYY YYYY YYYY YYYY YYYY
YYYY RRRR RRRR RRRR YYYY RRRR RRRR RRRR YYYY RRRR RRRR RRRR YYYY
YYYY RRRR YYYY RRRR YYYY RRRR YYYY RRRR YYYY RRRR YYYY RRRR YYYY
YYYY RRRR YYYY RRRR YYYY RRRR YYYY RRRR YYYY RRRR YYYY RRRR YYYY
YYYY RRRR RRRR RRRR YYYY RRRR YYYY RRRR YYYY RRRR YYYY RRRR YYYY
YYYY RRRR YYYY YYYY YYYY RRRR YYYY RRRR YYYY RRRR YYYY RRRR YYYY
YYYY RRRR YYYY YYYY YYYY RRRR YYYY RRRR YYYY RRRR YYYY RRRR YYYY
YYYY RRRR YYYY YYYY YYYY RRRR YYYY RRRR YYYY RRRR YYYY RRRR YYYY
YYYY RRRR YYYY YYYY YYYY RRRR RRRR RRRR YYYY RRRR RRRR RRRR YYYY
YYYY YRYR YYYY YYYY YYYY YYYY YYYY YYYY YYYY YYYY YYYY YYYY YYYY

Player 0 0
SmartThief 5 5
FloorFollowingThief 3 4
Door 12 9
Clock 0 9
Mirror 1 0
Coffee 12 0
Key 6 3 RED
Gate 6 4 RED
Bomb 6 0
Bomb 6 9
Loot 2 0 TIER_1
Loot 3 0 TIER_2
Loot 4 0 TIER_3
Loot 5 0 TIER_4
// Direction is mandatory for flying assassin
FlyingAssassin 6 5 RIGHT
Mirror 8 5
