0 100

13 10
YYYY YYYY YYYY YYYY YYYY YYYY YYYY YYYY YYYY YYYY YYYY YYYY YYYY
YYYY RRRR RRRR RRRR YYYY RRRR RRRR RRRR YYYY RRRR RRRR RRRR YYYY
YYYY RRRR YYYY RRRR YYYY RRRR YYYY RRRR YYYY RRRR YYYY RRRR YYYY
YYYY RRRR YYYY RRRR YYYY RRRR YYYY RRRR YYYY RRRR YYYY RRRR YYYY
YYYY RRRR RRRR RRRR YYYY RRRR YYYY RRRR YYYY RRRR YYYY RRRR YYYY
YYYY RRRR YYYY YYYY YYYY RRRR YYYY RRRR YYYY RRRR YYYY RRRR YYYY
YYYY RRRR YYYY YYYY YYYY RRRR YYYY RRRR YYYY RRRR YYYY RRRR YYYY
YYYY RRRR YYYY YYYY YYYY RRRR YYYY RRRR YYYY RRRR YYYY RRRR YYYY
YYYY RRRR YYYY YYYY YYYY RRRR RRRR RRRR YYYY RRRR RRRR RRRR YYYY
YYYY YRYR YYYY YYYY YYYY YYYY YYYY YYYY YYYY YYYY YYYY YYYY YYYY

Player 0 0 1
SmartThief 5 5 5
FloorFollowingThief 3 4 5 RED
Door 12 9
Clock 0 9
