// Score (starts at zero for levels), Start Time (in milliseconds)
4 100000

13 10
YYYY YYYY YYYY YYYY YYYY YYYY YYYY YYYY YYYY YYYY YYYY YYYY YYYY
YYYY MMMM MMMM MMMM YYYY YYYY YYYY YYYY YYYY CCCC CCCC CCCC YYYY
YYYY MMMM YYYY MMMM YYYY YYYY YYYY YYYY YYYY CCCC YYYY CCCC YYYY
YYYY MMMM MMYY MMMM YYYY YYYY YYYY YYYY YYYY CCCC CCYY CCCC YYYY
YYYY YYYY YYYY YYYY YYYY YYYY YYYY YYYY YYYY YYYY YYYY YYYY YYYY
YYYY YYRR YYRR YYYY YYYY YYYY YYYY YYYY YYYY YYYY RRRR RRRR YYYY
YYYY RRRR RRRR YYYY YYYY YYYY YYYY YYYY YYYY YYYY RRRR RRRR YYYY
YYYY RRRR RRRR RRRR RRRR RRRR RRRR RRRR RRRR RRRR RRRR RRRR YYYY
YYYY RRRR RRRR RRRR RRRR RRRR RRRR RRRR RRRR RRRR RRRR RRRR YYYY
YYYY YYYY YYYY YYYY YYYY YYYY RRRR YYYY YYYY YYYY YYYY YYYY YYYY

Player 6 3
FloorFollowingThief 9 2
FlyingAssassin 1 8 RIGHT
FlyingAssassin 11 7 LEFT
Door 12 9
Clock 0 9
Mirror 11 5
Coffee 1 7
Coffee 11 7
Coffee 12 8
Key 6 9 GREEN
Key 1 2 RED
Gate 2 3 GREEN
Gate 11 1 RED
Gate 10 3 RED
Loot 0 0 TIER_1
Loot 7 9 TIER_2
Loot 5 0 TIER_3
Loot 11 2 TIER_4
